00,00,00,00,00,00,00,00,00,00,00,00,00,00,00,00,00,00,00,00,00,00,00,00,00,00,00,00,00,00
00,03,04,04,04,04,04,04,04,04,04,04,04,04,04,04,04,04,04,04,04,04,04,04,63,64,65,04,05,00
00,01,24,45,46,47,10,11,14,15,10,11,25,23,25,23,18,19,25,25,24,25,22,57,58,66,67,68,06,00
00,01,25,48,49,50,12,13,16,17,12,13,25,25,25,25,20,21,25,25,25,25,25,59,60,69,70,71,06,00
00,01,25,51,52,53,25,10,11,14,15,25,14,15,25,25,25,25,25,18,19,25,25,61,62,72,73,74,06,00
00,01,24,54,55,56,22,12,13,16,17,25,16,17,25,23,22,25,24,20,21,25,23,25,25,08,08,24,06,00
00,01,25,25,08,24,25,28,29,30,40,25,25,25,25,25,25,25,25,25,25,25,25,22,25,08,08,25,06,00
00,01,25,25,08,25,25,31,32,33,41,43,22,25,23,22,25,25,25,25,23,25,25,25,25,08,08,25,06,00
00,01,22,25,08,25,23,34,35,36,42,44,25,25,25,25,24,22,25,25,25,25,25,22,25,08,08,24,06,00
00,01,25,25,08,24,25,37,38,39,25,25,25,22,25,25,25,25,24,25,25,24,25,25,25,08,08,25,06,00
00,01,25,25,08,25,27,25,08,25,25,25,23,25,25,25,25,25,25,23,22,23,23,25,25,08,08,25,06,00
00,01,25,25,08,25,26,25,08,25,23,25,25,25,24,25,14,15,25,25,25,25,25,25,25,08,08,25,06,00
00,01,24,25,08,25,25,25,08,25,25,25,25,25,25,25,16,17,25,25,25,23,25,25,25,08,08,25,06,00
00,01,25,25,08,08,08,08,08,08,08,08,08,08,08,08,08,08,08,08,08,08,08,08,08,08,08,25,06,00
00,01,25,25,25,25,25,25,25,25,24,08,24,23,23,25,24,25,25,24,08,25,25,25,25,25,25,25,06,00
00,01,25,22,25,24,25,22,25,25,25,08,25,25,18,19,25,10,11,25,08,25,24,25,25,25,24,25,06,00
00,01,25,25,25,25,25,25,25,25,25,08,22,25,20,21,22,12,13,22,08,25,25,25,22,25,25,25,06,00
00,01,25,25,25,23,25,25,22,25,25,08,25,25,24,25,22,25,25,22,08,25,25,25,25,25,25,25,06,00
00,01,25,25,22,25,25,25,25,25,24,08,24,23,25,23,25,24,25,08,08,25,22,25,25,22,25,24,06,00
00,01,24,25,25,24,25,22,25,25,25,08,08,08,08,08,08,08,08,08,25,25,25,25,25,25,25,25,06,00
00,01,25,25,25,25,24,25,25,23,25,25,25,25,24,25,25,25,25,08,25,25,25,25,24,25,25,25,06,00
00,01,25,22,25,25,25,25,25,25,25,25,25,25,25,25,25,25,24,08,08,25,25,22,25,25,23,25,06,00
00,01,25,25,25,25,25,22,25,25,22,25,25,25,25,23,25,25,25,25,08,08,25,25,25,25,25,25,06,00
00,01,25,25,23,25,25,25,25,25,25,25,25,23,22,24,25,23,25,25,25,08,08,25,25,25,25,25,06,00
00,01,24,25,25,25,25,25,25,25,24,25,25,25,24,22,25,25,25,25,25,22,08,08,25,25,22,75,76,77
00,01,25,25,22,24,25,22,25,25,25,23,25,25,23,25,25,25,25,25,25,25,25,08,08,08,08,78,79,80
00,01,25,25,25,25,25,25,25,25,22,25,25,25,24,23,25,25,25,23,25,25,24,25,22,25,25,25,06,00
00,01,25,25,25,25,25,24,23,25,25,25,25,25,22,25,25,23,25,25,25,25,25,25,25,25,24,23,06,00
00,02,07,07,07,07,07,07,07,07,07,07,07,07,07,07,07,07,07,07,07,07,07,07,07,07,07,07,81,00
00,00,00,00,00,00,00,00,00,00,00,00,00,00,00,00,00,00,00,00,00,00,00,00,00,00,00,00,00,00